|------------------|
|   4   5          |
|   2             6|
|               5 7|
|       7          |
|                 3|
|                 2|
|                  |
|                  |
|                 4|
|------------------|