|------------------|
| 7 4   5          |
|   2   3 7 8     6|
|           9   5 7|
| 4     7          |
| 9               3|
|           3     2|
| 1 5   9          |
| 2     1 4 7   9  |
|           2   1 4|
|------------------|